W W W W W W W W W W W W W W W W W W W W W W W W W W W W
W F F F F F F F F F F F F W W F F F F F F F F F F F F W
W F W W W W F W W W W W F W W F W W W W W F W W W W F W
W A W W W W F W W W W W F W W F W W W W W F W W W W A W
W F F F F F F F F F F F F F F F F F F F F F F F F F F W
W F W W W W F W W F W W W W W W W W F W W F W W W W F W
W F W W W W F W W F W W W W W W W W F W W F W W W W F W
W F F F F F F W W F F F F W W F F F F W W F F F F F F W
W W W W W W F W W W W W F W W F W W W W W F W W W W W W
E E E E E W F W W W W W E W W E W W W W W F W E E E E E
E E E E E W F W W E E E E B B E E E E W W F W E E E E E
E E E E E W F W W E W W W G G W W W E W W F W E E E E E
W W W W W W F W W E W E E E E E E W E W W F W W W W W W
E E E E E E F E E E W I I P P C C W E E E F E E E E E E
W W W W W W F W W E W E E E E E E W E W W F W W W W W W
E E E E E W F W W E W W W W W W W W E W W F W E E E E E
E E E E E W F W W E E E E S S E E E E W W F W E E E E E
E E E E E W F W W E W W W W W W W W E W W F W E E E E E
W W W W W W F W W E W W W W W W W W E W W F W W W W W W
W F F F F F F F F F F F F W W F F F F F F F F F F F F W
W F W W W W F W W W W W F W W F W W W W W F W W W W F W
W F W W W W F W W W W W F W W F W W W W W F W W W W F W
W A F F W W F F F F F F F F F F F F F F F F W W F F A W
W W W F W W F W W F W W W W W W W W F W W F W W F W W W
W W W F W W F W W F W W W W W W W W F W W F W W F W W W
W E F F F F F W W F F F F W W F F F F W W F F F F F F W
W F W W W W W W W W W W F W W F W W W W W W W W W W F W
W F W W W W W W W W W W F W W F W W W W W W W W W W F W
W F F F F F F F F F F F F F F F F F F F F F F F F F F W
W W W W W W W W W W W W W W W W W W W W W W W W W W W W