W W W W W W W W W W W W W W W W W W W W W W W W W W W W
W F F F F F F F F F F F F W W F F F F F F F F F F F F W
W F W W W W F W W W W W F W W F W W W W W F W W W W F W
W F W W W W F W W W W W F W W F W W W W W F W W W W F W
W F F F F F F F F F F F F F F F F F F F F F F F F F F W
W F W W W W F W W F W W W W W W W W F W W F W W W W F W
W F W W W W F W W F W W W W W W W W F W W F W W W W F W
W F F F F F F W W F F F F W W F F F F W W F F F F F F W
W W W W W W F W W W W W F W W F W W W W W F W W W W W W
E E E E E W F W W W W W E W W E W W W W W F W E E E E E
E E E E E W F W W E E E E E E E E E E W W F W E E E E E
E E E E E W F W W E W W W W W W W W E W W F W E E E E E
W W W W W W F W W E W E E E E E E W E W W F W W W W W W
E E E E E E F E E E W E E E E E E W E E E F E E E E E E
W W W W W W F W W E W E E E E E E W E W W F W W W W W W
E E E E E W F W W E W W W W W W W W E W W F W E E E E E
E E E E E W F W W E E E E S S E E E E W W F W E E E E E
E E E E E W F W W E W W W W W W W W E W W F W E E E E E
W W W W W W F W W E W W W W W W W W E W W F W W W W W W
W F F F F F F F F F F F F W W F F F F F F F F F F F F W
W F W W W W F W W W W W F W W F W W W W W F W W W W F W
W F W W W W F W W W W W F W W F W W W W W F W W W W F W
W F F F W W F F F F F F F F F F F F F F F F W W F F F W
W W W F W W F W W F W W W W W W W W F W W F W W F W W W
W W W F W W F W W F W W W W W W W W F W W F W W F W W W
W F F F F F F W W F F F F W W F F F F W W F F F F F F W
W F W W W W W W W W W W F W W F W W W W W W W W W W F W
W F W W W W W W W W W W F W W F W W W W W W W W W W F W
W F F F F F F F F F F F F F F F F F F F F F F F F F F W
W W W W W W W W W W W W W W W W W W W W W W W W W W W W