W W W W W W W W W W W W W W W W W W W W W W W W W W W W
W P P P P P P P P P P P P W W P P P P P P P P P P P P W
W P W W W W P W W W W W P W W P W W W W W P W W W W P W
W P W W W W P W W W W W P W W P W W W W W P W W W W P W
W P P P P P P P P P P P P P P P P P P P P P P P P P P W
W P W W W W P W W P W W W W W W W W P W W P W W W W P W
W P P P P P P W W P P P P W W P P P P W W P P P P P P W
W W W W W W P W W W W W P W W P W W W W W P W W W W W W
E E E E E W P W W W W W E W W E W W W W W P W E E E E E
E E E E E W P W W E E E E E E E E E E W W P W E E E E E
E E E E E W P W W E W W W W W W W W E W W P W E E E E E
W W W W W W P W W E W E E E E E E W E W W P W W W W W W
E E E E E E P E E E W E E E E E E W E E E P E E E E E E
W W W W W W P W W E W E E E E E E W E W W P W W W W W W
E E E E E W P W W E W W W W W W W W E W W P W E E E E E
E E E E E W P W W E E E E E E E E E E W W P W E E E E E
E E E E E W P W W E W W W W W W W W E W W P W E E E E E
W W W W W W P W W E W W W W W W W W E W W P W W W W W W
W P P P P P P P P P P P P W W P P P P P P P P P P P P W
W P W W W W P W W W W W P W W P W W W W W P W W W W P W
W P W W W W P W W W W W P W W P W W W W W P W W W W P W
W P P P W W P P P P P P P P P P P P P P P P W W P P P W
W W W P W W P W W P W W W W W W W W P W W P W W P W W W
W W W P W W P W W P W W W W W W W W P W W P W W P W W W
W P P P P P P W W P P P P W W P P P P W W P P P P P P W
W P W W W W W W W W W W P W W P W W W W W W W W W W P W
W P W W W W W W W W W W P W W P W W W W W W W W W W P W
W P P P P P P P P P P P P P P P P P P P P P P P P P P W
W W W W W W W W W W W W W W W W W W W W W W W W W W W W